111111111111111
1000000000P0001
111100000000001
100000000E00001
101111000000111
111111111111111
