111111111111111111111
1000C100000000001E011
P00000000000000000011
111111111111111111111
