111111111111111
1000000000P0001
1111000C0000C01
100000000E00001
101111000000111
111111111111111