11111111111111111
11111111111111111
1111110C001110111
11111000111111111
11100P1111C011111
11111000C00111111
11110C001100E1111
11111111111111111
11111111111111111