1111111
100C001
1P000E1
1111111