11111111111111111111
11111111111111111111
111P00001110000C1111
11001111000111100011
11001111101111100111
11100111111111001111
11110011111110011111
11111001111100111111
11111100000001111111
111111111E1111111111
11111111111111111111
