11111111111111111111111111111
11111111111111111111111111111
11111111111111111111111111111
111P0011000111110000000C11111
11100011000111100000000001111
11100011000111111111110001111
11100000000111111111000111111
11100000000111111000011111111
11111111000111110001111111111
11111111000111000111111111111
11111111000111000000000001111
11111111000CCCCCCC00000E11111
11111111111111111111111111111
11111111111111111111111111111
