11111111111111111111
11110001111100011111
111P00001110000C1111
11001110000011100111
11001111000111100111
11100111101111001111
11110011111110011111
11111001111100111111
11111100111001111111
111111100E0011111111
11111111000111111111
11111111101111111111
11111111111111111111
