111111
1PCE11
111111
111111
111111
111111