11111111111111111111
11110001111100011111
111P00001110000C1111
11000000000000000111
11000000000000000111
11100000000000001111
11110000000000011111
11111000000000111111
11111100000001111111
111111100E0011111111
11111111000111111111
11111111101111111111
11111111111111111111
