1111111111111111111111111
111P01100111110000000C111
1110011001111000000000011
1110011001111111111100011
1110000001111111110001111
111C000001111110000111111
1111111001111100011111111
1111111CC1110001111111111
1111111001110000000000011
1111111C00CCCCCCC00000E11
1111111111111111111111111
