111111111111111
100000000000001
1111000C0000C01
100000000EP0001
101111000000111
111111111111111